.......................................................
.......................................................
...........................lxr...lxr...lxxr.lxr........
........................lxr.1.lxr.1.lxr................
....0................0.................0..0..0.........
XXXXXXXXXR.LXXXXXXXXXXXXR.............LXXXXXXXXXXXXXXXX