.............................................
.............................................
........*................0...................
................xxxx...lxxxr.................
....0.........xx..1..0.......................
XXXXXXXXXR.LXXXXXXXXXXXXXR..LXXXXXXXXXXXXXXXX