.......................................................
.......................................................
...........................lxr...lxr...lxxr.lxr........
........................lxr...lxr...lxr................
....0..22222222......0..2...1.....1....0..0..0.........
XXXXXXXXXR.LXXXXXXXXXXXXR.............LXXXXXXXXXXXXXXXX