.............................................
.............................................
........*....................................
.............................................
....0.............1..........................
XXXXXXXXXR.LXXXXXXXXXXXXXR..LXXXXXXXXXXXXXXXX