......................................................................................
.......................................................222222222222222................
...........................lxr...lxr...lxxr.lxr.......................................
........................lxr...lxr...lxr...............................................
....0..22222222......0..2...1.....1....0..0..0.........222222222222222................
XXXXXXXXXR.LXXXXXXXXXXXXR.............LXXXXXXXXXXXXXXXR...............LXXXXXXXXXXXXXXX