.............................................
.............................................
........*................0...................
................xxxx...lxxxr.................
....0.........xx..1..........................
XXXXXXXXXR.LXXXXXXXXXXXXXR..LXXXXXXXXXXXXXXXX