.................................................
.................................................
.................................................
.................................................
......2.............0.......1....................
XXXXXXXXXR..LXXXXXXXXXXXXR......LXXXXXXXXXXXXXXXX