.................................................
.................................................
..lxxr........222222.............................
.............22..................................
......2.....222.....0.......1....................
XXXXXXXXXR..LXXXXXXXXXXXXR......LXXXXXXXXXXXXXXXX